XXX.......XXX
XX.........XX
X...XXXXX...X
...XXXXXXX...
..XXXXXXXXX..
..XXX...XXX..
..XXX...XXX..
..XXX...XXX..
..XXXX.XXXX..
...XXX.XXX...
X...XX.XX...X
XX.........XX
XXX.......XXX