....X....
.........
....X....
....X....
X.XXXXX.X
....X....
....X....
.........
....X....